2222222222523222252222523232225222223222332252222232222552232222222252222222522222232222225222235222
2222225222232222222222225322222222222222222322222532223222222522322253222223232222552222222222225222
2222222222222223222232352222222222222222222223222323222222222225222322222222222222322252222522222222
2222222222222252322232522222223222222322322233222232222222222222222232222222222332222222232333233222
2222222222222222222522232222332222223222522222325222225222222222222222222232322222222222222222225225
2222222222232232323222232222222222222222223522223255222222222222222322223222223222322225222223322222
2232252222222552222222223332222222522232222322222322222222222222223222222323533232522222223232232232
2222222252222222222222222222223222223222222522232322332222232223222522332222222332222522222252222232
2252222222222222223222222232332222222222222222222232222322325222222222222222222222222222223222232222
2322222252222223222253222222232322223222222222532223222222222222222322222252223223222222222222322322
2233222222222232225222522252223222222222223232325222322222232222222222222222222222522222222222222222
2222333222222222222222222522222222222322233222222222222225222223222232222222232222222222222222232222
2235222252222232232222223222222322222222222222222232222222225222322322222222222232222222222322222222
2222222322222222222222222222522223222253222233222222222222332232222223222222252222222222232223223232
2523222332252222222222223222222222223322222222252223222222222225223232222222322222222222232225222322
2222233322322222332222252252222223322225222222222222222352223225222232222232222222222223322223322222
2222222322233232225232222222222233222222222222223323252222222223225322222223222322222223222222222222
3222222232222222222222223223322222222322232523352322222233223223222223323255222222222222222223232222
2252532225222222322222322222222233222225222222232222222222222222322232225222223522222222332222222222
2222222222222232222232222222222222252222232232252222222232323222222222223222222252222223232222222223
2222222222252222232322222222223222223222222222322223222222222222222222223322222222222222222222222222
2222522222522223232323223222222252223222223222322222223252322232322222222232222222522322222222322222
2323223223322222222222223252223222232222222222222222322222222222222332222522222222322222222523222222
3222222222252222223222222223322223522222222222532222222222232222332222232222322222223222222222222222
2222222222522222222322222222232223223222232222322223222222323222322222222322222223223222223222223222
2222222222223252222232222222222252322232322222222222225232222223232223222222222223252222232222222222
3323222222252222222232222222222225225222222222222222222223223225232252322222222223532222233232253222
2322322222222322322252252322222322222222223222232222252222533253322232232322233222222222322222222222
2522222222322222222522225222222222222222222522222322522222522222222253222222222222222222222322222222
2222223232222522222223222222222222223232322222232222222232222222222222222322232222222222222222222222
2222222232222222222222322322222222233222222225222222223222222222222232223222225322222322222322222222
2233222322222225222222323252222322232222522252222222222222222223223222232222222222222222322222222522
2322522222222322223222222322233323222222222222222222522222322322322332222322222332222232222222222222
2222222222222252222322322222233322223232232232222222322322232222522222223225322332222222222222232222
2322222233322222222322222222222223232223222322223222252222222222232222222222322222322222222222222222
2225252222232222222222222222222222222222222252222222222222222323222222222222225222222522222222222323
2222222222222222322222222332222223222222223222223222222522222222322552322222222222222222223223232532
2355222223222222223222322225222232223233222222222233222522225222232232222323322222232332222222525222
3222552553222222252323232222222222235322223222232222222223322222322222222222232222222222222222222222
2322232222233222222222522222223222222352222222222222222232532222222222222222232222522222223222223252
2222322222223222222522222223223222222222222222252322222222232222252223222222332232222222222222322223
2222232222222323223222522222532222222222222222222222223223222222222222222322222223232322222223232532
2252222222332222222223223225222222222223223232323322223222322232223332223222232233222222352222222232
2222222232323523222322222222322232222223225222232223222222223222232222222323222225222222222222222232
5222222222222522222222223323322222223222222222222222222222322523222222223232222222222323222232225522
2232223222222222325223322222222222222222222222225222322222322232222222222253222222222222222222222222
2232232223232322322222225222222223222222222222222222222222222332222333222222322232232222222222222222
2222222225222222222522253222222323522223222522222232223222322222222522222222222223222222222223222232
2223222222222252352222222222222222232222322222322222222222222222322222222222222223222232322322233222
3332222322232222222222222222222232222222232222223222222323223222232222222222322322223222222352222232
