000000000000000000000000000000000000000000000000000000000000000000000000000000000000000000
000000000000000000000000000000000000000000000000000000000000000000000000000000000000000000
000000000000000000000000000000000000000000000000000000000000000000000000000000000000000000
222222322222222322223222222222232235223522223222223223332352322222222232223322223222222322
222222222222222222232232222223232222222222222222232322232223222322225222222232222222222222
222322532222222222232322222222232232332222232222222222322222222222222222223223325222223322
222223223222222222322222222232255222322222222222322222222222223223222222222223222222222222
222222222322252222222222252252222222322222222252222222252222222222222222232222222222223222
222222222222232222222222232232332325222223232222232222222222222222222523222222522222225222
222222222223222222222222222322252322222222223222222222222222222222222222252233322225222222
322222222223222222222222223323222222323222233222322322332232522222222222222222222322222222
232222222222222222322225222222222222322222322222232222322255223252222223222223522222322232
332222525522222222222222322222225333222222322222322222222222322223222222523232252222222322
222232522325222222322322222222222323222222522223222232232232222322222232232322222322222222
222222353222223232222332232523222222222222222222222222322232225252522522522322223322222222
222222222222222522322222222222222222222222222222252232322222222222222222222222223222322222
223222222222222532223522223322222232232223222222232222232223222222222222323323222222222222
352523532232222222222222232222223222222222222252222223225222322222322222523223222222252222
232222222222223222222322522232223222522223332223323222222522522222222322222332222222222222
532222222222235222232252222222223322322332523222222222222222223222232232222222222222222323
222522222322222322232222222322222252222232522222222222223222222222222532232225225222222222
232222222253222222222223523223222232223223523322223252222225223222222232232322232222222222
222232222233222322222222222232232222222222252222222222222323225222222222222222222322223222
222222222222225222233232252222222222222322222222232223252222222332222222222523222222232222
222322252222223322222222322222222222232222222222222222222222222322522232222222252332222222
232223222232322222223222222222222222222252235322223223222523222222222322233222222222232222
222222232222222522232222222252222225222222222223223232223222223222232222222222252253222223
222253232222222222222222223222222222333222232252322322222222322522222222322222222222232222
222222222322325233222222222232222322222222322232233222222322225222232222222222222222222222
222223222222223222332223232323252322222222222222252222222222252222222235225222222222222222
222222222222223252322222222322222222232222522222233223222222232522252225523222222222522222
222222322223223222222222222222325222225222222223223222322223222252222223223232233252222322
332222222222333222332225222233222322222222222232322222222252232222322222222322322322222225
222525322523252222222223232222222222523223222222222222222222222322322223322222222325222223
222222322322222222222222223223322222222223222233222223522223222322222252222222222222232232
222322222222223222532223222223222223222252232232322222222222222252522222322222222222222222
222522222222322232222222252222252222222222222222232222323232222222222332325222222222222222
222222222232222252223222222253223332222223223222222252322322222222232223223222322222352222
225223232335222222222222222322322222222253322222222232322223222222352222222323222223222222
232233222222222232222225222222222232223222222522232222222522222523222253322225222222322222
222522222222223222222222252223222252222223222232222222222222222223222222232222222222232222
