000000000000000000000000000000000000000000000000000000000000000000000000000000000000000000
000000000000000000000000000000000000000000000000000000000000000000000000000000000000000000
000000000000000000000000000000000000000000000000000000000000000000000000000000000000000000
222222222222222232222222323222222222222232222222322222222232232222232222222223223223232332
222222233322222232222222222322522222232222232222332222252222222222222222222252222222222225
225332232222222222222222222252522232323322323322252322222222222235222322222522222222223222
222222222322222222322232222222232222222222225222322222522232232222222232233222222222222222
222222222222222222222232222222232225222222222222222222222222222222222222222222222222222222
222222323222222252222222222222322222222222222252222222222232523222225222222522232222222225
222222223222223325222222222222222222225222222222222225222222222322222222222322222222222222
323232222222222223222232222252222222222222222323235222223222322222222222223222222223222222
232522223222222222222253222222522225222222322222322235223222222222232222223222223232222223
222232222322222222223222222322222223222222222222252332222222222252322522523222222223322232
222222222522325222222222252232222222322222222322323222225332222222255222222222223222222222
223222322222222222222222222222252323222223225232322522222223332522222232225222222322222222
222232222222222225232252222222222222223222232222222322222222222222222222222332252322222222
322222222232222522223222232222322223222222222222232222232223225232222222222522222222252222
252322222222322222332222222222222252222522332222322222223223225232222222222222222223322222
333222225232222222255222222222522222222222225222222522223222222322322222222222322222222222
232222222222222222222222222322223232222222222223222223222223223233322222222222222222222222
222223225222223222222222222222222222222222322322222232222222322335222222222223322222223222
322332222222222522222222222232222222222522322322222222352322322222532332223222322222332232
332222252222222222222252222225222222232322232225222223225252223222222252222222222252222222
222222222222222222222232322233223253232322222322222223252322232222222332222223222222222222
222232222222222332222222222323222223222332323233222222552223222222232252222222232322223222
222223222222232222232322222222332223522222233332222225222222222232232322522222232222222223
222222223222222225333222222222322222222225233232252252222223225232252222232222232222222232
222232322222232222222322222222322232323223222223222222232222222225222255223223322222223222
222322222222222222232323222222222222253222222225322222222523222222222322222222222222223223
222232222222222322222222252222322222322222222222223222222222222223322222222252322222222232
222232232222222222355223222222222222332332222222223222222222322222222232222223222222222222
222222322222322222222222222222222232222232222222222225222222222232252252322222522222232222
322223222222222222252222232522222322222222222222222222222222233222222232232222222222222222
222222323232222522222222232222222223222225222222222222222222222322222322232222222222223322
222322222222223222323222222222222232223223222222222222322322332233225222222222335522222222
232222222222222222252222222325222222322222222222222222253222323222225222222322222222222223
222222225232322332232322523222322232225322222222222225222225223322222322222222222222222222
222222222222222223222222222222222222233223222323223222322232222223232523223222222223232532
222232232222222222222322332222255323322222222222222223222222322222223225322232222222222222
222222223322252252223222232222223222222222222222222223232222322322232225222322232222332222
222522225222222323223222222222322222222222222352232222222223323232322232222222222222222222
