000000000000000000000000000000000000000000000000000000000000000000000000000000000000000000
000000000000000000000000000000000000000000000000000000000000000000000000000000000000000000
000000000000000000000000000000000000000000000000000000000000000000000000000000000000000000
233222252222223222232222222222222322252222222222222222222222222223222222222222232232223222
232222223323222222222532222322222222222322222523222322222222222222222232322522222222322222
222252222222222222222222222322222222225222322522222223232332322322322222222232233232222222
222222322222222222222232222225222223232222222222222222222223223232222222222222222225322222
322222322232222222223223222522522322222222223225522222222222223222222222222222223222323233
225222222222322222222222322222222522223322222222235223232222223322222232233222522322222222
222222222522322322222222223353232223222222222252222322222222222232522222222222222222322352
252222222223332222222222222232222322252232532222223222522332222222222323322222223222222222
252222222222352222222222222222222232222222322222532222222222222232532322225232222222222222
222222222222322222222322223325323552225222232322222222232222222222222222223232222223222222
222322222222232255322333222523232222222222222325222225232332222222222232225322222222222222
232222222222223322222222223232222223222223222222222225222352223322222222222222222222222522
522252222222233222322222222322222223323222222322322225222222332222223222322252223322222222
252322232222233222222322232222222222222233222222222222222522322332323222223323223222222222
222222222222222223222222222222223325532322222222232222223222222222232522222222222222332222
222222223222223322222225222222222252222222222223222222222222222232232322222222232222225222
233223222222225232222322222222222222232222322222222323222223222222222223222222222222222322
232222223222222222532223222253222522222222222222222223222223222522222222222222332225323222
232222223222252222222222233222323222222222223222232222222223322222222222232222225222525222
222223222232522525223222222322222252322222222332523222222322222222222222222225222223252222
322222222222322222222322222222332223222232222222222232222223532222222222222222322222252332
232222222223222522222222222222222522222222222222222223222222253222322222522522222222222232
222222222222225323232222222223222225223222222522322222223225222222222222222222222223232232
222222222222222223222222332222322232222222222223222222222222222222522222235222232222322222
322222222222222222223523222222225222322222225223232222222222222222222222535232233222222223
222222322232223222232225222222222222222222222232222222222222222222222255235222322222222322
222332222222223253222322222222322222222222222222232222222222223322223225332322252222252222
222222222232523222222222222222222222252322522522222222233222222222322232222222222222222222
222232222522222222222222222222322222225222222322222332522222222222222222222222222233222322
222222222232232522223232222222222322222222252222252222223222222222232223222222232222322222
222222223323222232322222222222223232222225223233222223222223222222222222322222252522225222
225322222522522222322223222222222232222233223222222532323222223222222322223232223222322223
322223232222222222222232252222223233222252322222222222232352222222222232522353232222222222
222223252352222222222222232222223322223222522222222232522223223322222222222223222222222222
222333222222225232522322232222252222222532222222222232222232222522322222222232222222222322
232322222222223253225222222232223225325225323222222322253222322232322222222222522232222225
222222222222222222222222225222222222252323322225232232322232322252233222222322222222322222
222223222222222222222222223222225223232222222222232222222222222223222322222322322222223222
222322332222252222222232222322222222252222222222223222222222222322222222222222222232225222
