000000000000000000000000000000000000000000000000000000000000000000000000000000000000000000
000000000000000000000000000000000000000000000000000000000000000000000000000000000000000000
000000000000000000000000000000000000000000000000000000000000000000000000000000000000000000
222222223222252222222222222222222522222222222322222352222223222335222322223222222222222222
223222222522533232222232222222222222222235522222332322222222232223222223222522322222222222
222222222222222222322252222222222322222222322222222222222222222332323222222222222222223225
222522222222322322222222222222222222222222222222232222322225222222222225252232222232223223
225222222222222223223222252222223322522222222522222522222222225233222232232222222222222252
322222222222223223322222222222222522222233222322232222232232222222222222222322222222232222
222322222222225522222232235233223222323232222322222522222222222223222223222223232222223352
222322232252322222252222222222325222222223322223222222222222232222222235222222232222252235
222222222222222323223323522222222222222222222225222222222222223222222322222222222523222222
232232222222523222322232222222222222225232223222522322322322322222225225222222222323225222
323222332322222232232232222232322222232223322322222222222222223235222232322222222222222232
225222222223225322322322222223222232222222222223232322333322222252222222223222222222222223
232222222232222222252522222222222222222223222223222222222222522235223223222232322222223222
223522222232232222223232252222222222252252222222323222323222232222232223222223222222222322
322225222222322352252222222222232222222252232222232222222222225222222322222222222222222332
523222322222323222323222222222232222222222222222225222232232222222233223323222332222222222
223222232322222232222222252222232322233223322232222223222322222522223222223253222222222322
222222222222522252232323222232222323522232255235222222222223222232222222523222352222222222
222252225222222222322232222225253322232232222222223232322222322222222222325225222222222232
233222222232222222222323223222232222222222222223222525223222222222222322322252222222222322
222322222522223322223232222222232232222522225223222222322222232222222232222232222222232223
222222222232222222222222222222223222222222522232222222232222222222253223232222222222322223
322222222222322222225222222233223222222322222525222222322222222222232222232322222222322222
222322223222232222222233222252533222232223232222323222322522222232222322322222222322222222
322522222322222222222222223222222222232522223532222522222222222222252222222222222232222222
322222222322222222222222232222232222222222222252222232223222222222222222322222222223233222
222222222522222222222222322252225222222222252222223325222222232222222232522222322232223222
222222222222232223252222222232232222232222222222222222222222223223222222222222222323222222
232222232222222222252223222222232222322222222222222222232252352223222222232322225222223322
222222222222222222222522222223522232222322222222222222222322222352252222222322223252232232
222322222232222223222223222222222223232222222222222522222322222323222522232222322222222232
322222322222232223232322322222252223522222223322222322222222222222322522232322223322222222
222222222222225232223222222222222252222232223223325322222225222222223222322222222222222222
222232232222222232222252223232222222223222325222322322522222322222523222225252232222222222
232522222223322223232222222322222222222222225222332223222222522222223222222232223222222222
222222222223222252222522232222223222222222222352222323222232222532222225222222222222232222
232232222225222322222222232222222222222222522222222222222222222252322223222222252222222222
222222222222222222222222222233222222222222232232222222222222322222252222222222222222332222
